                                                                                                    
           ### ### # ########### #       ################# ############# # ####### #################
           # #   # # #   #   # # #         #   # # #   # # # # # # #     #   #   # # # # # # # #    
           ###   ##### ### ##### ####### # ##### ### # ####### # ### ### ######### ### ### # #######
           # #       #   # #   # # # #   # # # # # # # #     #   # # #       # # # #   #     #   #  
         ##### ######### ########### # # ### # ### ######### ##### ##### # ### ##### ### ##### # ###
             # #   #   # # # #     #   # # # # # # #   # # # # #     # # # # #     # # #   # # # # #
         ##### ####### ############### ### ##### ####### ##### ######### ########### ####### # #####
           # #         #   #     #   # #   #   # #   # # # # # # # #   # #   # # #   # # # #   #    
         ### #####   ####### ############### ### ##### # ####### ### # ### #######   ### ### #######
         #       #         # # #   #     # # #   # #   # # #   # # # # # #     # #   # #   #     #  
         ###     #####   # ### # ### ####### ####### ### # # ####### ############# # ### ###########
           #         #   # # #   #         #   #                   # #   # # #     #   #     # # #  
         ###         #   ##### #################     #######     # # ### ### # ######### ##### #####
         #           #       #   #   # # # # # #     #     #     # # #   # # # #     # # # # #     #
       ###           ### ### ### ##### # ##### ##### # ### #     ########### ###   ####### #########
       #               #   # #   # # #   #   #       # #   #       #   # # # # #     # # #   # # #  
       #               # ##### ### # # # ### # ####### # # ####### #   ### ### # ##### ###########  
       #               # # # # # # #   # #       #     # #       #     #   # # #     # #   # #   #  
       #########     ### ###################   ###   ##### ### # # ########### # ##### ### ### # ###
             # #     #         #     #         #         # #   # #       #   # # # #   #     # # #  
             # #     #       #####   # ######### ######### # ### ##### # ####### ### ### #   #####  
               #     #                 #         # # # # # # # #     # # #     # #     # #       #  
           #####     ### ##### #####   ### ####### # # ############# ### ##### ######### #########  
           #           # #   # #   #     #   #   #                     #       # # # # # # # # # #  
       ##### ###       ###   # #   #     ### ### ############### ####### ####### ### ### #########  
       #     # #             # #   #       # #                 # #       # # # # # # # # # #     #  
       # ### # #########     ### ###       # #         ####### ### # ####### ### ### ##### ##### ###
       # # # #         #         #         # #           # # #     # # #   #   # #   #   # # #   #  
       ### ###       ###     #######   ##### ###       ##### ### ##### ########### # ####### ### ###
                     #       #         #       #       #   # #       # # # # #   # # # # # # #   #  
                     ###     #   ####### #     #       ################### ####### ### # # #########
                       #     #   #       #     #       # # #     # #   # # # # # # # # # # #   #    
                       #     #####   ##### ### #####   ### ### # ##### # ### # ### ### ###########  
                       #             #   # #       #   # #     # #   # # #     # # # # #   # # # #  
                     ### ####### # # ### ##### #####   ### ### ### # ######### ####### ### ### # ###
                     #   #   # # # # #   #     #       #   # #   # #           #   # # #   # # # # #
                     #####   # # ##### ###     ##### # ### # # ### ############# ##### ####### #####
                             # #   # # # #       #   # # # # #   # #   # # # # # # # # # #   # #   #
                             # ### ### ##### ##### ####### # ### ####### ##### ####### # ######### #
                                 # #   # # # #         #   #   #     # #   # #     # # #   #        
                             ### # ######### ####### ##### # ####### ### ##### ##### ### ####### ###
                             # # #   #   #         # #     #       # # #       # # #   # #       #  
                         ##### # ### ########### # # ###   # ##### # # ###   # #####################
                           # # # #     # # # #   # # #     #   # # #   #     # # #   # #   # # # # #
                       ##### # # ##### ########### # ### ### ### ###   ######### # ######### ### ###
                       #       #     #     #   # # #     #     #       #   #             # #   # # #
                       # ### # #     ##### # ##### ###   ###   ### ####################### # ### ###
                       # # # # #         #       #   #     #     #             # #   # # # #   # # #
                     ### # ### #         #       #####   ###     ##### ######### ### # ##### ### ###
                     #     # # #         #       #       # #         #   # # # # #     #   # # # # #
                   ### # # # # # #     ### ##### ###     # # ### ### # ##### ############### ##### #
                   #   # #   # # #     # # #   #   #     #     #   # # #   # # # # # #   # # #   #  
             #######   ####### #####   # # # ###   ###   ### ######### ### ##### ### ##### # #####  
             # #       #   #       #   #       #     #     #         #   #   # # # #     #     # #  
             # #   ############### #   ### #####     #     #######   ### ### ####### ###############
             #           # # # # # #     # # # #     #           #     #     # # #     #   # # #    
         #####   ### ######### ### ##### # #####     #           #     #     ################# ### #
         #         # #     #   # #     # # #         #           #     #     #   # # # # # # # # # #
         # ############### ##### ##### ### ######### ### #     ###     ##### ### ### ##### ### ### #
         #   # # #     #   # #   # # #         # #     # #     #           #     # #     # #       #
         ### ### ################# # # # #   ######### ####### ###         # ##### #   ### #########
           # #   #   #   #   #       # # #   # #   # #       #   #         # # # # #       # # # # #
           # ##### ### ### # ######### ###   ####### # ### #######       ### # ### ### ####### ### #
           #   # #   # # # # # # # # # # #   #   # # # #                 #     #   #     #   #   # #
           ### # ### # ##### ### # ### ####### ### ##### ### #           ##### ############# #######
             #   # # # #     # #   # # # # # # # #   # #   # #               #   # # # #   # #      
           ### ####### ######### ##### # # # ######### ##### #               # ### ### ##### #######
           # #       # # # # # #     # #     #     # # # # # #               #   # # # # # # # # #  
         ### # ####### ####### ####### ####### ####### # # ###               ### ##### ###########  
         #         # #       # # # # #   # #   # #   #     # #                 # #   #           #  
         # ################### ##### ####################### # #             ### #####   ##### ###  
         #   #           #   # #   # # # #   #     # # # #   # #             #     # #   # # #   #  
         # # ############### ### ####### ### #   ### ##### # ###             # #######   # # ### ###
         # # #     # # #   # # # #     #           # #   # # # #             # # #       #     # # #
 ######### ### ### ### ####### ##### ############### ##### ##### # ######### # ### ### ### ##### ###
 # #         # #   #   # #   # # # #     # # # # # # # # # #   # # #       # # #   # # #   #       #
 # # ####### ##### ##### ### # ##### ############# # ### ######### # # ### ### # ### # # ### #######
 #   # # #   #   # # # # #   # #   #             #   #   # #   # # # #   #       #   # # #   #   # #
 ### # ### ###   ### # # ##### ### ########### ####### ### ### ### # #######   ### # ### ##+###### #
   # # # # # #   # # # # # # # #   #   # # # #   # # # # # # #   # #   #   #   #   #     # #   # #  
   # # ### ####### # # # ### ### ################# # ### ######### ### ### # ###   ####### #######  
   # # # # #   # # # #   #   # #     #   #     # # # #   # #   # #   #   # #   #   # #   # # # # #  
 # # ######### ### ##### ### ########### ##### # ######### ##### ### ##### #   ### ####### ####### #
 # #   #         # #     # #   # # # # # #   # # #     # #   # # # #       #     # #   # # # #     #
 ##### # ####### ######### ##### ######### ##### # # # ### # ##### ### # # ##### # ######### #######
 #   #   #   #       # # # # # #     # # # #   #   # # # # # # # # # # # #     # #   #   # # # #    
 ### ####### ##### # ####### ### # # ####### # ######### # ### # # # ##### # # ### ### # ###########
 # #             # # #   #   # # # # #     # # # #     # #       #   #   # # #       # # #   #   # #
 ### ####### ##### ########### ### ### ### ####### ##### # # ####### ##### # ########### ### #######
 #     #   # #     #   # # # #   #   # #   #     #   # # # # # #       # # # # # # #   # # # #   # #
 # ##### ##### ####### ####### ### ######### ######### ####### ### ### ########### ##### ### ### ###
 # #             #   # #     # # #   # # # #       # # # # # # # # # # # # # #         # # # #   # #
 # ###       ##### # ####### ### ### ### ############# ####### ### ### ### ########### ### # #######
     #           # # # # # # # #     #   #   # # # #   #     # # # # # # # #   # # # # # # #   #   #
 # #####       # ##### ######################### ######### ##### ##### # ##### ####### # ####### ###
 #     #       # #   #           # #   # # # #       #     #   # # # #   #     # # # # # #     # # #
 ####### ####### ######### ############### ########### # ##### ### # ####### ####### # ###     # ###
 # #     # # # # # # # #     #   #   #     #   # # # # # #     # # # # # # #       # # # #       # #
 # ####$ # # ###########   #############   # ##### # ### ### ######### # # #       # ### ### #######

