                      ###     #######         ### ##### ########### ###   ###########   ############# 
                      # #     #     #         # # #   #         # # # #   #         #   #           # 
                      # #     # ##### ######### ### ### ####### # ### ### # ##### ###   #           # 
                      # #     #     # #             #   #     # #       # # #   # #     #           # 
                      # ####### ### ### ########### ##### # ### #####   ### ### # ####### ###       # 
                      #         # #     # # # # # #       # #       #         # #         # #       # 
                  #####   ####### # ####################### #       ########### ##### ##### #####   # 
                  #       #       #   # # # # # # # # # # # #                       # #         #   # 
              #####   ### # ##### ### ##################### #######     ###   ##### ###     ### # ### 
              #       # # # # # #   # # # # # # # # # # # #       #     # #   #   #         # # # #   
              ####### # ### ##### ### ######################### ### ### # #####   #     ##### # # ### 
                    # #     # # # #   # # # # # # # # # # # #   #   # # #         #     #     # #   # 
                    # # ######### # ######################### ### ### # #         # ##### ### # # ### 
                    # # # # # #   # # # # # # # # # # # # # # #     # # #         # #     #   # # #   
    ##### #####     ########### ### ######################### ### ### ###         # ##### ### ### ### 
    #   # #   #                 #   # # # # # # # # # # # # #   # #               #     # # #       # 
  ### ### # ###   ##### ### ##### ############################# # ###             # ##### # ####### # 
  #   #   # #     #   # # # #     # # # #     # # # # # # # # # #   #             # #     #       # # 
  # ####### ###   #   # # ### ########### ### ################# ### ###           ### ### ##### # ### 
  #           #   #   # #     # # #       # # # # # # # # # # #   #   #               #       # #     
  # ##### # ### ### ### ### ####### ####### # ####################### #         ####### ###   # ##### 
  # #   # # #   #   #     #   # # # #       #       # # # #         # #         #     # # #   #     # 
  # #   # #######   # ### ### ##### # ###   ####### ####### ####### ###         #     # # ### ####### 
  # #   #     #     # # #   #       # # #         #         #     #             #     # #   #       # 
  # ### ##### # ### ### ##### ##### # # # ##### # ##### ### ##### #           ###     # ### ### ### # 
  #   #     #   # #           #   # # # # #   # #     # # #     # #           #       #   #   # # # # 
  ### ###   # ### # ###########   # # # ### ### ##### ### ##### # #     ##### ### ### # ###   ### # # 
    #   #   # #   # #             # # #     #     # #         # # #     #   #   # # # # #         # # 
  ##### # ### #   # #       ##### # ### ### ##### ########### ### #     #   #   ### # ###       ### # 
  #     # #   #   # #       #   # #     # #     # # # # # # #     #     #   #       #           # # # 
  ####### #####   ###       ### ##### ### # ### ################# #     #   # ##### #   ###     # # # 
                              #     # #   # # # #       # # # #   #     #   # # #   #   # #     #   # 
                              ##### # # ### # ### ##### ####### ###     #   ### ### ##### #     ### # 
                                  # # # #   #     #   # #       #       #         #       #       # # 
                                ### # # ##### ##### ### # ##### #       ### ##### ####### ####### ### 
                                #   # #       #     #   # #   # #         # # # #     # #       #     
                                # ### #     ###     ### # # ### # ### ### # ####### ### ####### ### # 
                                #     #     #         #   # #   # # # # # # # # # # #       # #   # # 
                                #######     ###       ##### # ### # ### ### ####### ####### ### ### # 
                                              #             # # # #           # # #       # # # #   # 
                                            ### ##### ### ### # # #       ### ########### # ### # ### 
                                            # # #   # # # #     # #       # # # #       # #     # # # 
                            ### ###         # # ### # ### ####### ######### # ### ####### ####### ### 
                            # # # #         #     # #   #                   #     #     #         # # 
                            # ### ###       ###   # ### ################### # ##### ### ### ######### 
                            #       #         #   #   #   # # # # # # # #   # #     #     # # # # # # 
                    ####### ### ### #         ### # # ### ############### ### # ######### # ######### 
                    #     # # # # # #           # # #   #     # # # # #   #   # #     #   # # # # # # 
                    # ##### # # #########       # # ### ##### ######### ### ### #     ##### ######### 
                    # #     # #         #       # # # #     # # # # # # #   #   #           # # # # # 
                    # # ##### ##### ### #       # ### ##### # ######### ##### # #   ##### ########### 
                    # #     #     # # # #       #   #       # # # # # #       # #   #   # # # # # # # 
                    # ##### ### ### # ### ###   #   # ####### ################# #   #   # ########### 
                    #     #     #   #     # #   #   # #       # # # # # # # # # #   #   # # # # # # # 
                    ###   # #####   ####### #   ### # # ####################### ##### ### ########### 
                      #   # #               #     # # #   # # # # # # # # # # #       #   # # # # # # 
                      #   # #         ##### ###   ### ### ######################+###### ############# 
                      #   # #         #   #   #         # # # # # # # # # # # # # #     # # # # # # # 
                      ### ###         #   #   ###       # ########################################### 
                        #             #   #     #       #   # # # # # # # # # # # # # # # # # # # # # 
                  ###   # ###         ### ### ###       ### ######################################### 
                  # #   # # #           #   # #           #   # # # # # # # # # # # # # # # # # # # # 
                  # #   # # #         ### ### #           ### ####################################### 
                  # #   # # #         #   #   #             # # # # # # # # # # # # # # # # # # # # # 
                  # #   # # #       ### # #####         ##### ####################################### 
                  # #   # # #       #   #               #     # # # # # # # # # # # # # # # # # # # # 
                  # ### # # ####### ##### #####       ### ########################################### 
                  #   # # #       #     #   # #       #   # # # # # # # # # # # # # # # # # # # # # # 
      ########### #   ### ####### ##### ##### #####   ### ########################################### 
      #         # #           #       #           #     #   # # # # # # # # # # # # # # # # # # # # # 
      # ### ##### # #####     # ####### ######### #     ### ######################################### 
      # #   #     # #   #     # #       # # # # # #       # # # # # # # # # # # # # # # # # # # # # # 
    ### # ###     # ### ####### # ############### #     ### ######################################### 
    #   # #       #   #         # # # # # # # # # #     #   # # # # # # # # # # # # # # # # # # # # # 
    #   ### ###   ##### # ###   # ############### #     # ########################################### 
    #   #   # #   #     # # #   # # # # # # # # # #     # # # # # # # # # # # # # # # # # # # # # # # 
  ###   ##### ### ####### # ##### ############### ####### ########################################### 
  #             #   # # # #       # # # # # # # #         # # # # # # # # # # # # # # # # # # # # # # 
  #             ### ##### # ######################################################################### 
  #               #   #   # # # # # # # # # # # # # # # # # # # # # # # # # # # # # # # # # # # # # # 
  #               ### # ### ######################################################################### 
  #                 #   #   # # # # # #     #       # # # # # # # #       # # # # # # # # # # # # # # 
  #           ####### ### ############# ### # ##### ############### ##### ########################### 
  #           #       #   # # # # # #   # #   #   #       # # #     #   # # # # # # # # # # # # # # # 
  ###         #       # ############# ### ##### ### ##### ##### ##### # # ########################### 
    #         #       # # # # # # #   #         #   #   #       #     # # # # # # # # # # # # # # # # 
  ###   ##### #       # ########### ###   ##### ### ### ####### # ##### # ########################### 
  #     #   # #       # # # # #     #     #   #   #   #       # # # # # # # # # # # # # # # # # # # # 
  #######   # ######### ####### #####     ### ### ### # ### # # # ##### # ########################### 
            #           # # # # #           #   #   # # # # # # # # # # #   # # # # # # # # # # # # # 
            ##### ############# #           ### ##### ### # # ### ##### ### ######################### 
                #               #             #           # #     # # #   #       # # # # # # # # # # 
                ####### ### #####             ### ####### # ##### ####### # ##### ################### 
                      # # # #                   # #     # #   # #   # # # # #   #     # # # # # # # # 
                    ### # ###                   # # ##### ##### ### ##### ### $ ##### ############### 
                    #   #                       # # #   #         # # # #     #     # # # # # # # # # 
                    #   #                       ### ### ### ##### # ######### ### ### ############### 
                    #   #                             #     # #   # # # # # #   # #   # # # # # # # # 
                    #####                             ####### ################# ### #################
